####################################################################################################################################################################################
####################              #####################################         ################            ##############################       ######           ##################
#          #########              ###############       ####         ##         ####         ###            ##############################       ######           ##################
#          #########              ###############       ####         ##         ####         ###            ##############################       ######           ##################
#          #########              ###############       ####         ##         ####         ###            ##########                           ######           ##################
#          #########              ###############       ####         ##         ####         ###            ########## ##################        ######           ##################
#                                                                                            ###            ########## ##################        ######           ##################
#          #########              ### ###########       ####         ##         ####         ###            ####             ############        ######           ####         #####
#          #########              ### ###########       ####         ##         ####         ######## ##########             ############        ############ ########         #####
#          #########              ### ###########       ######## ######         ####         ######## ##########             ############ ### ############### ########         #####
#          #########              ### ###########       ######## ######         ####         ######## ##########             ############ ### ############### ########         #####
#          #########              ### ###########       ####        ###         ####         ######## ##########             ########         ############### ########         #####
#          #########              ### ###########       ####        ###         ####### ########            ####             ########                                          #####
#          ############### ########## ###########       ####        ####### ########### ########            ####             ########         ############        ####         #####
#          ############### ########## ###########       ####        ####### ########### ########            ####             ########         ############        ####         #####
#          ############### ########## ##############                ####### ########### ########                                                                  ####         #####
####### ################## ########## ############## #######        ####### ########### ########            ####             ########         ############        ####         #####
####### ######           # ########## ############## #######        ####### ########### ########            ####             ########         ############        ####         #####
####### ######           # #             ########### #######        ###         ####### ########            ####             ########         ############        ####         #####
####### ######           # #             ########### #######        ###         ###           ##            ########## #############################################################
####### ######           # #             ########### ##################         ###           ######################## #############################################################
#           ##                           ########### ##################         ###           ######################## #############################################################
#           ##           ###             ########### ##################         ###           ######################## #############################################################
#           ##           ###             ########### ##################         ###           ##         ############# #############################################################
#           ##           ###             ########### ##################         ###           ##         ###       ### ###############################################          ####
#           ##           ###             ########### ###################### #######           ##         ###       ###            ####################################          ####
#           ##           ###             ########### ###################### ##########   #######         ###       ###            ####################################          ####
#           ###################### ## ############## ###################### ##########   #######         ###       ###            ####################################          ####
#           ###################### ## ############## ###################### ##########   #######         ###       ###            ####################################          ####
#           ###################### ## ############## ###################### #######        #####                                  ####################################          ####
#           ###################### ## ############## ##################        ####        #####         ###       ####           ####################################          ####
#           ###################### ## ############## ##################        ####        #####         ###       ####           #########             ################### ########
#           ###################### ## ############## ##################        ####        ######### #######       ####           #########             ################### ########
######  #########################          #####          #############        ####        ######### #######       ####           #########             ################### ########
######  ######        ###########          #####          #############        ####        ######### #######       ######### ##############             ################### ########
####       ###        ###########          #####          #############        ####        ######### ####################### ##############             ################### ########
####       ###        ###########          #####                               ########  ########### #####################                              ################### ########
####       ###        ###########          #####          #############        ########  ########### ##################### # ##############             ################### ########
####                                                                           ########  ########### ##################### # ##############             ################### ########
####       ###        ###########          #####          #############        ####          ###           ###############       ##########             ################### ########
####       ###        ###########          #####          #############        ####          ###           ###############       ##########             ################### ########
####       ###        ###########          ############################        ####          ###           ###############       ##########             ################### ########
####       ###        ###########          ############################        ####          ###           ###############                        ######################### ########
####### #########################          ############################        ####          ###            ##############       ################ ######################### ########
####### ################################################################### #######          ###            ##############       ################ ######################### ########
####### ################################################################### #######          ###            ##############       ################ ######################### ########
####### #########        ##############          ######################         ###          ###            ##############       ##########         ####################### ########
####### #########        ##############          ######         #######         ###          ###            ############## #  #############         ####################### ########
####### #########        ###       ####          ######         #######         ###          ###            ############## #  #############         ####################### ########
####### #########                                ######         #######         ###          ############## ############## #           ####         ####################### ########
####### #########        ###       ####          ######         #######         ###          ############## ############## #           ####         ###        #########        ####
#             ###        ###                     ######         #######         #######  ################## ############## #           ####         ###        #########        ####
#             ###        ###       ####          ######         #######         #######  ################## ############## #           ####         ###        #########        ####
#             ###        ###       ####          ######         #######         #######  ################## ############## ##          ####         ###        #########        ####
#                                  ######## ###########         #######         #######                                                                                         ####
#             ############################# ###########         ########### ###########  ################## ############## ###         ################        #########        ####
#             ############################# ############### # ############# ###########  ################## ############## ############################        #########        ####
#             #####         ############### ############### # #########          ######  ############              ####### ############################        #########        ####
##### #############         #############         ######### # #########          ######  ############              ####### ############################        #########        ####
##### #############         #############         ######### # #########          ######  ############              ####### ############################        #########        ####
##### #############         #############         ###             #####          ######  ############                      #########################################################
##### #############         #############         ###             #####          ######  ############              ####### #########################################################
##### #############                               ###             #####          ######  ############              ####### #########################################################
##### #############         ######## ####         ###             #####          ######  ############              ####### #########################################################
##### #############         ######## ####         ###             ######### ###########  ############              ####### #########################################################
##### #############         ######## ####         ###             ######### ########       ################## #########       #####       ###       ###         ####################
##### #############         ######## ####         ###             ######### ########       ################## #########       #####       ###       ###         ####################
##        ############### ########## ###### #########             ######### ########       ################## #########       #####       ###       ###         ##########        ##
##        ############### ########## ###### ################# ############# ########       ################## #########       #####       ###       ###         ##########        ##
##        ############### ########## ###### ################# #########          ###       ################## #########                   ###       ###         ##########        ##
##        ############### ########## ###### ################# #########          ###       ###############       ######       #####       ###       ###         ##########        ##
##        ############       ###          # ##############       ######          ###       ###############       ######                                                           ##
##        ############                                                           ###       ###############       ######       #####       ###       ###         ##########        ##
##        ############       ###          # ##############       ######          ###       ###############       ######       #####       ###       ###         ##########        ##
##        ############       ###            ##############       ######          ###       ###############       ######       ###############       ###         ##########        ##
##        ############       ###          ################       ######          ###       ###############       ############################       ###         ##########        ##
##        ############       ###          ################       ######          ###       ###############       ############################       ###         ##########        ##
##        ############       ###          ################       ###################       ##################################################       ###         ####################
######################       #############################       ###################       ##################################################       ###         ####################
####################################################################################################################################################################################
